%BASISPACKAGEPREFIX%WITHOUTDOTPACKAGEVERSION-%LANGUAGESTRING	Language module for LibreOffice %PRODUCTVERSION, language %LANGUAGESTRING
%BASISPACKAGEPREFIX%WITHOUTDOTPACKAGEVERSION-%LANGUAGESTRING-base	Base language module for LibreOffice %PRODUCTVERSION, language %LANGUAGESTRING
%BASISPACKAGEPREFIX%WITHOUTDOTPACKAGEVERSION-%LANGUAGESTRING-binfilter	Legacy filters (e.g. StarOffice 5.2) for LibreOffice %PRODUCTVERSION, language %LANGUAGESTRING
%BASISPACKAGEPREFIX%WITHOUTDOTPACKAGEVERSION-%LANGUAGESTRING-calc	Calc language module for LibreOffice %PRODUCTVERSION, language %LANGUAGESTRING
%BASISPACKAGEPREFIX%WITHOUTDOTPACKAGEVERSION-%LANGUAGESTRING-draw	Draw language module for LibreOffice %PRODUCTVERSION, language %LANGUAGESTRING
%BASISPACKAGEPREFIX%WITHOUTDOTPACKAGEVERSION-%LANGUAGESTRING-fonts	Language fonts module for LibreOffice %PRODUCTVERSION, language %LANGUAGESTRING
%BASISPACKAGEPREFIX%WITHOUTDOTPACKAGEVERSION-%LANGUAGESTRING-help	Language help module for LibreOffice %PRODUCTVERSION, language %LANGUAGESTRING
%BASISPACKAGEPREFIX%WITHOUTDOTPACKAGEVERSION-%LANGUAGESTRING-impress	Impress language module for LibreOffice %PRODUCTVERSION, language %LANGUAGESTRING
%BASISPACKAGEPREFIX%WITHOUTDOTPACKAGEVERSION-%LANGUAGESTRING-math	Math language module for LibreOffice %PRODUCTVERSION, language %LANGUAGESTRING
%BASISPACKAGEPREFIX%WITHOUTDOTPACKAGEVERSION-%LANGUAGESTRING-onlineupd	Online update language module for LibreOffice %PRODUCTVERSION, language %LANGUAGESTRING
%BASISPACKAGEPREFIX%WITHOUTDOTPACKAGEVERSION-%LANGUAGESTRING-res	Language resource module for LibreOffice %PRODUCTVERSION, language %LANGUAGESTRING
%BASISPACKAGEPREFIX%WITHOUTDOTPACKAGEVERSION-%LANGUAGESTRING-writer	Writer language module for LibreOffice %PRODUCTVERSION, language %LANGUAGESTRING
%BASISPACKAGEPREFIX%WITHOUTDOTPACKAGEVERSION-activex	ActiveX control for LibreOffice %PRODUCTVERSION
%BASISPACKAGEPREFIX%WITHOUTDOTPACKAGEVERSION-base	Base module for LibreOffice %PRODUCTVERSION
%BASISPACKAGEPREFIX%WITHOUTDOTPACKAGEVERSION-binfilter	Legacy filters (e.g. StarOffice 5.2) for LibreOffice %PRODUCTVERSION
%BASISPACKAGEPREFIX%WITHOUTDOTPACKAGEVERSION-calc	Calc module for LibreOffice %PRODUCTVERSION
%BASISPACKAGEPREFIX%WITHOUTDOTPACKAGEVERSION-core01	Core module for LibreOffice %PRODUCTVERSION
%BASISPACKAGEPREFIX%WITHOUTDOTPACKAGEVERSION-core02	Office core module for LibreOffice %PRODUCTVERSION
%BASISPACKAGEPREFIX%WITHOUTDOTPACKAGEVERSION-core03	Office core module for LibreOffice %PRODUCTVERSION
%BASISPACKAGEPREFIX%WITHOUTDOTPACKAGEVERSION-core04	Office core module for LibreOffice %PRODUCTVERSION
%BASISPACKAGEPREFIX%WITHOUTDOTPACKAGEVERSION-core05	Office core module for LibreOffice %PRODUCTVERSION
%BASISPACKAGEPREFIX%WITHOUTDOTPACKAGEVERSION-core06	Office core module for LibreOffice %PRODUCTVERSION
%BASISPACKAGEPREFIX%WITHOUTDOTPACKAGEVERSION-core07	Office core module for LibreOffice %PRODUCTVERSION
%BASISPACKAGEPREFIX%WITHOUTDOTPACKAGEVERSION-dict-gl	Gl dictionary for %PRODUCTNAME %PRODUCTVERSION
%BASISPACKAGEPREFIX%WITHOUTDOTPACKAGEVERSION-dict-vi	Vietnamese dictionary for %PRODUCTNAME %PRODUCTVERSION
%BASISPACKAGEPREFIX%WITHOUTDOTPACKAGEVERSION-draw	Draw module for LibreOffice %PRODUCTVERSION
%BASISPACKAGEPREFIX%WITHOUTDOTPACKAGEVERSION-emailmerge	Email mailmerge module for LibreOffice %PRODUCTVERSION
%BASISPACKAGEPREFIX%WITHOUTDOTPACKAGEVERSION-gnome-integratn	Gnome integration module for LibreOffice %PRODUCTVERSION
%BASISPACKAGEPREFIX%WITHOUTDOTPACKAGEVERSION-graphicfilter	Graphic filter module for LibreOffice %PRODUCTVERSION
%BASISPACKAGEPREFIX%WITHOUTDOTPACKAGEVERSION-headless	Headless display module for LibreOffice %PRODUCTVERSION
%BASISPACKAGEPREFIX%WITHOUTDOTPACKAGEVERSION-images	Images module for LibreOffice %PRODUCTVERSION
%BASISPACKAGEPREFIX%WITHOUTDOTPACKAGEVERSION-impress	Impress module for LibreOffice %PRODUCTVERSION
%BASISPACKAGEPREFIX%WITHOUTDOTPACKAGEVERSION-javafilter	Java filter module for LibreOffice %PRODUCTVERSION
%BASISPACKAGEPREFIX%WITHOUTDOTPACKAGEVERSION-kde-integration	KDE integration module for LibreOffice %PRODUCTVERSION
%BASISPACKAGEPREFIX%WITHOUTDOTPACKAGEVERSION-math	Math module for LibreOffice %PRODUCTVERSION
%BASISPACKAGEPREFIX%WITHOUTDOTPACKAGEVERSION-onlineupdate	Online update modul for LibreOffice %PRODUCTVERSION
%BASISPACKAGEPREFIX%WITHOUTDOTPACKAGEVERSION-ooofonts	Mailcap module for LibreOffice %PRODUCTVERSION
%BASISPACKAGEPREFIX%WITHOUTDOTPACKAGEVERSION-ooolinguistic	Linguistic module for LibreOffice %PRODUCTVERSION
%BASISPACKAGEPREFIX%WITHOUTDOTPACKAGEVERSION-pyuno	Pyuno module for LibreOffice %PRODUCTVERSION
%BASISPACKAGEPREFIX%WITHOUTDOTPACKAGEVERSION-spellcheck	English spellchecker module for LibreOffice %PRODUCTVERSION
%BASISPACKAGEPREFIX%WITHOUTDOTPACKAGEVERSION-testtool	Testtool module for LibreOffice %PRODUCTVERSION
%BASISPACKAGEPREFIX%WITHOUTDOTPACKAGEVERSION-writer	Writer module for LibreOffice %PRODUCTVERSION
%BASISPACKAGEPREFIX%WITHOUTDOTPACKAGEVERSION-xsltfilter	XSLT filter samples module for LibreOffice %PRODUCTVERSION
%PACKAGEPREFIX%SOLARISBRANDPACKAGENAME%BRANDPACKAGEVERSION-dict-af	Af dictionary for %PRODUCTNAME %PRODUCTVERSION
%PACKAGEPREFIX%SOLARISBRANDPACKAGENAME%BRANDPACKAGEVERSION-dict-cs	Cs dictionary for %PRODUCTNAME %PRODUCTVERSION
%PACKAGEPREFIX%SOLARISBRANDPACKAGENAME%BRANDPACKAGEVERSION-dict-da	Da dictionary for %PRODUCTNAME %PRODUCTVERSION
%PACKAGEPREFIX%SOLARISBRANDPACKAGENAME%BRANDPACKAGEVERSION-dict-de	De dictionary for %PRODUCTNAME %PRODUCTVERSION
%PACKAGEPREFIX%SOLARISBRANDPACKAGENAME%BRANDPACKAGEVERSION-dict-en	En dictionary for %PRODUCTNAME %PRODUCTVERSION
%PACKAGEPREFIX%SOLARISBRANDPACKAGENAME%BRANDPACKAGEVERSION-dict-es	Es dictionary for %PRODUCTNAME %PRODUCTVERSION
%PACKAGEPREFIX%SOLARISBRANDPACKAGENAME%BRANDPACKAGEVERSION-dict-et	Et dictionary for %PRODUCTNAME %PRODUCTVERSION
%PACKAGEPREFIX%SOLARISBRANDPACKAGENAME%BRANDPACKAGEVERSION-dict-fr	Fr dictionary for %PRODUCTNAME %PRODUCTVERSION
%PACKAGEPREFIX%SOLARISBRANDPACKAGENAME%BRANDPACKAGEVERSION-dict-hu	Hu dictionary for %PRODUCTNAME %PRODUCTVERSION
%PACKAGEPREFIX%SOLARISBRANDPACKAGENAME%BRANDPACKAGEVERSION-dict-hr	Hr dictionary for %PRODUCTNAME %PRODUCTVERSION
%PACKAGEPREFIX%SOLARISBRANDPACKAGENAME%BRANDPACKAGEVERSION-dict-it	It dictionary for %PRODUCTNAME %PRODUCTVERSION
%PACKAGEPREFIX%SOLARISBRANDPACKAGENAME%BRANDPACKAGEVERSION-dict-lt	Lt dictionary for %PRODUCTNAME %PRODUCTVERSION
%PACKAGEPREFIX%SOLARISBRANDPACKAGENAME%BRANDPACKAGEVERSION-dict-ne	Ne dictionary for %PRODUCTNAME %PRODUCTVERSION
%PACKAGEPREFIX%SOLARISBRANDPACKAGENAME%BRANDPACKAGEVERSION-dict-nl	Nl dictionary for %PRODUCTNAME %PRODUCTVERSION
%PACKAGEPREFIX%SOLARISBRANDPACKAGENAME%BRANDPACKAGEVERSION-dict-pl	Pl dictionary for %PRODUCTNAME %PRODUCTVERSION
%PACKAGEPREFIX%SOLARISBRANDPACKAGENAME%BRANDPACKAGEVERSION-dict-pt	Pt dictionary for %PRODUCTNAME %PRODUCTVERSION
%PACKAGEPREFIX%SOLARISBRANDPACKAGENAME%BRANDPACKAGEVERSION-dict-ru	Ru dictionary for %PRODUCTNAME %PRODUCTVERSION
%PACKAGEPREFIX%SOLARISBRANDPACKAGENAME%BRANDPACKAGEVERSION-dict-sk	Sk dictionary for %PRODUCTNAME %PRODUCTVERSION
%PACKAGEPREFIX%SOLARISBRANDPACKAGENAME%BRANDPACKAGEVERSION-dict-sl	Sl dictionary for %PRODUCTNAME %PRODUCTVERSION
%PACKAGEPREFIX%SOLARISBRANDPACKAGENAME%BRANDPACKAGEVERSION-dict-sv	Sv dictionary for %PRODUCTNAME %PRODUCTVERSION
%PACKAGEPREFIX%SOLARISBRANDPACKAGENAME%BRANDPACKAGEVERSION-dict-sw	Sw dictionary for %PRODUCTNAME %PRODUCTVERSION
%PACKAGEPREFIX%SOLARISBRANDPACKAGENAME%BRANDPACKAGEVERSION-dict-th	Th dictionary for %PRODUCTNAME %PRODUCTVERSION
%PACKAGEPREFIX%SOLARISBRANDPACKAGENAME%BRANDPACKAGEVERSION-dict-zu	Zu dictionary for %PRODUCTNAME %PRODUCTVERSION
%WITHOUTDOTUNIXPACKAGENAME%BRANDPACKAGEVERSION	Brand module for %PRODUCTNAME %PRODUCTVERSION
%WITHOUTDOTUNIXPACKAGENAME%BRANDPACKAGEVERSION-%LANGUAGESTRING	Brand language module for %PRODUCTNAME %PRODUCTVERSION
%WITHOUTDOTUNIXPACKAGENAME%BRANDPACKAGEVERSION-base	Base brand module for %PRODUCTNAME %PRODUCTVERSION
%WITHOUTDOTUNIXPACKAGENAME%BRANDPACKAGEVERSION-calc	Calc brand module for %PRODUCTNAME %PRODUCTVERSION
%WITHOUTDOTUNIXPACKAGENAME%BRANDPACKAGEVERSION-draw	Draw brand module for %PRODUCTNAME %PRODUCTVERSION
%WITHOUTDOTUNIXPACKAGENAME%BRANDPACKAGEVERSION-impress	Impress brand module for %PRODUCTNAME %PRODUCTVERSION
%WITHOUTDOTUNIXPACKAGENAME%BRANDPACKAGEVERSION-math	Math brand module for %PRODUCTNAME %PRODUCTVERSION
%WITHOUTDOTUNIXPACKAGENAME%BRANDPACKAGEVERSION-writer	Writer brand module for %PRODUCTNAME %PRODUCTVERSION
